6 6 6 6 6 6 6 6 6 6 6 6 6 6 6 6 6 6 6 6 6 6 6 6 6 6 6 6 6 6 6 6 6 6 6 6 6 6 6 6 6 6 6 6 6 6 6 6 6 6 6 6 6 6 6 6 6 6 6 6 6 6 6 6 6 6 6 6 6 6 6 6 6 6 6 6 6 6 6 6 6 6 6 6 6 6 6 6 6 6 6 6 6 6 6 6 6 6 6 6 
6 6 6 6 6 6 6 6 6 6 6 6 6 6 6 6 6 6 6 6 6 6 6 6 6 6 6 6 6 6 6 6 6 6 6 6 6 6 6 6 6 6 6 6 6 6 6 6 6 6 6 6 6 6 6 6 6 6 6 6 6 6 6 6 6 6 6 6 6 6 6 6 6 6 6 6 6 6 6 6 6 6 6 6 6 6 6 6 6 6 6 6 6 6 6 6 6 6 6 6 
6 6 6 6 6 6 6 6 6 6 6 6 6 6 6 6 6 6 6 6 6 6 6 6 6 6 6 6 6 6 6 6 6 6 6 6 6 6 6 6 6 6 6 6 6 6 6 6 6 6 6 6 6 6 6 6 6 6 6 6 6 6 6 6 6 6 6 6 6 6 6 6 6 6 6 6 6 6 6 6 6 6 6 6 6 6 6 6 6 6 6 6 6 6 6 6 6 6 6 6 
6 6 6 6 6 6 6 6 6 6 6 6 6 6 6 6 6 6 6 6 6 6 6 6 6 6 6 6 6 6 6 6 6 6 6 6 6 6 6 6 6 6 6 6 6 6 6 6 6 6 6 6 6 6 6 6 6 6 6 6 6 6 6 6 6 6 6 6 6 6 6 6 6 6 6 6 6 6 6 6 6 6 6 6 6 6 6 6 6 6 6 6 6 6 6 6 6 6 6 6 
6 6 6 6 6 6 6 6 6 6 6 6 6 6 6 6 6 6 6 6 6 6 6 6 6 6 6 6 6 6 6 6 6 6 6 6 6 6 6 6 6 6 6 6 6 6 6 6 6 6 6 6 6 6 6 6 6 6 6 6 6 6 6 6 6 6 6 6 6 6 6 6 6 6 6 6 6 6 6 6 6 6 6 6 6 6 6 6 6 6 6 6 6 6 6 6 6 6 6 6 
6 6 6 6 6 6 6 6 6 6 6 6 6 6 6 6 6 6 6 6 6 6 6 6 6 6 6 6 6 6 6 6 6 6 6 6 6 6 6 6 6 6 6 6 6 6 6 6 6 6 6 6 6 6 6 6 6 6 6 6 6 6 6 6 6 6 6 6 6 6 6 6 6 6 6 6 6 6 6 6 6 6 6 6 6 6 6 6 6 6 6 6 6 6 6 6 6 6 6 6 
6 6 6 6 6 6 6 6 6 6 6 6 6 6 6 6 6 6 6 6 6 6 6 6 6 6 6 6 6 6 6 6 6 6 6 6 6 6 6 6 6 6 6 6 6 6 6 6 6 6 6 6 6 6 6 6 6 6 6 6 6 6 6 6 6 6 6 6 6 6 6 6 6 6 6 6 6 6 6 6 6 6 6 6 6 6 6 6 6 6 6 6 6 6 6 6 6 6 6 6 
6 6 6 6 6 6 6 6 6 6 6 6 6 6 6 6 6 6 6 6 6 6 6 6 6 6 6 6 6 6 6 6 6 6 6 6 6 6 6 6 6 6 6 6 6 6 6 6 6 6 6 6 6 6 6 6 6 6 6 6 6 6 6 6 6 6 6 6 6 6 6 6 6 6 6 6 6 6 6 6 6 6 6 6 6 6 6 6 6 6 6 6 6 6 6 6 6 6 6 6 
6 6 6 6 6 6 6 6 6 6 6 6 6 6 6 6 6 6 6 6 6 6 6 6 6 6 6 6 6 6 6 6 6 6 6 6 6 6 6 6 6 6 6 6 6 6 6 6 6 6 6 6 6 6 6 6 6 6 6 6 6 6 6 6 6 6 6 6 6 6 6 6 6 6 6 6 6 6 6 6 6 6 6 6 6 6 6 6 6 6 6 6 6 6 6 6 6 6 6 6 
6 6 6 6 6 6 6 6 6 6 6 6 6 6 6 6 6 6 6 6 6 6 6 6 6 6 6 6 6 6 6 6 6 6 6 6 6 6 6 6 6 6 6 6 6 6 6 6 6 6 6 6 6 6 6 6 6 6 6 6 6 6 6 6 6 6 6 6 6 6 6 6 6 6 6 6 6 6 6 6 6 6 6 6 6 6 6 6 6 6 6 6 6 6 6 6 6 6 6 6 
6 6 6 6 6 6 6 6 6 6 6 6 6 6 6 6 6 6 6 6 6 6 6 6 6 6 6 6 6 6 6 6 6 6 6 6 6 6 6 6 6 6 6 6 6 6 6 6 6 6 6 6 6 6 6 6 6 6 6 6 6 6 6 6 6 6 6 6 6 6 6 6 6 6 6 6 6 6 6 6 6 6 6 6 6 6 6 6 6 6 6 6 6 6 6 6 6 6 6 6 
6 6 6 6 6 6 6 6 6 6 6 6 6 6 6 6 6 6 6 6 6 6 6 6 6 6 6 6 6 6 6 6 6 6 6 6 6 6 6 6 6 6 6 6 6 6 6 6 6 6 6 6 6 6 6 6 6 6 6 6 6 6 6 6 6 6 6 6 6 6 6 6 6 6 6 6 6 6 6 6 6 6 6 6 6 6 6 6 6 6 6 6 6 6 6 6 6 6 6 6 
6 6 6 6 6 6 6 6 6 6 6 6 6 6 6 6 6 6 6 6 6 6 6 6 6 6 6 6 6 6 6 6 6 6 6 6 6 6 6 6 6 6 6 6 6 6 6 6 6 6 6 6 6 6 6 6 6 6 6 6 6 6 6 6 6 6 6 6 6 6 6 6 6 6 6 6 6 6 6 6 6 6 6 6 6 6 6 6 6 6 6 6 6 6 6 6 6 6 6 6 
6 6 6 6 6 6 6 6 6 6 6 6 6 6 6 6 6 6 6 6 6 6 6 6 6 6 6 6 6 6 6 6 6 6 6 6 6 6 6 6 6 6 6 6 6 6 6 6 6 6 6 6 6 6 6 6 6 6 6 6 6 6 6 6 6 6 6 6 6 6 6 6 6 9 9 9 9 9 9 9 9 9 9 14 6 6 6 6 6 6 6 6 6 6 6 6 6 6 6 6 
6 6 6 6 6 6 6 6 6 6 6 6 6 6 6 6 6 6 6 6 6 6 6 6 6 6 6 6 6 6 6 6 6 6 6 6 6 6 13 9 9 9 9 9 9 9 9 9 14 6 6 6 6 6 6 6 6 6 6 6 6 6 6 6 6 6 6 6 6 6 9 9 35 0 2 0 3 0 0 0 0 0 0 34 9 14 6 6 6 6 6 6 6 6 6 6 6 6 6 6 
6 6 6 6 6 6 6 6 6 6 6 6 6 6 6 6 6 6 6 6 6 6 6 6 6 6 6 6 6 6 6 6 6 6 6 13 9 9 35 0 0 0 3 0 0 3 0 0 34 9 9 14 6 6 6 6 6 6 6 6 6 6 6 6 6 6 13 9 9 35 0 0 0 0 3 0 0 0 0 3 3 3 0 0 3 34 9 14 6 6 6 6 6 6 6 6 6 6 6 6 
6 6 6 6 6 6 6 6 6 6 6 6 6 6 6 6 6 6 6 6 6 6 6 6 6 6 6 6 6 6 6 13 9 9 9 35 0 0 0 0 0 3 3 0 0 0 0 0 0 0 0 34 14 6 6 6 6 6 6 6 6 6 6 6 6 6 8 0 3 0 0 3 0 3 3 0 3 0 0 2 0 3 0 3 0 0 0 34 6 6 6 6 6 6 6 6 6 6 6 6 
6 6 6 6 6 6 6 6 6 6 6 6 6 6 6 6 6 6 6 6 6 6 6 6 6 6 6 6 13 9 9 35 0 0 0 0 0 0 0 0 0 0 1 0 0 0 0 0 3 0 0 0 10 6 6 6 6 6 6 6 6 6 6 6 6 6 12 7 36 2 0 0 0 3 0 0 3 0 3 0 0 2 0 0 0 2 3 0 34 9 9 14 6 6 6 6 6 6 6 6 
6 6 6 6 6 6 6 6 6 6 6 6 6 6 6 6 6 6 6 6 6 6 13 9 9 9 9 9 35 0 0 0 0 0 3 0 0 0 3 0 0 0 3 0 1 0 0 0 0 0 3 0 10 6 6 6 6 6 6 6 6 6 6 6 6 6 6 6 12 7 7 36 0 0 2 0 0 0 0 3 0 0 0 3 0 3 3 0 0 3 3 10 6 6 6 6 6 6 6 6 
6 6 6 6 6 6 6 6 6 6 6 6 6 6 6 6 13 9 9 9 9 9 35 0 0 0 0 0 0 0 0 0 3 0 1 0 0 0 0 0 3 0 0 3 0 0 3 2 3 0 0 0 10 6 6 6 6 6 6 6 6 6 6 6 6 6 6 6 6 6 6 12 7 7 7 7 36 0 0 0 0 0 3 0 0 2 0 0 0 3 3 34 9 14 6 6 6 6 6 6 
6 6 6 6 6 6 6 6 6 6 6 6 6 6 13 9 35 0 0 0 0 0 0 0 0 0 0 0 3 0 0 0 0 0 0 0 0 0 3 0 3 0 0 0 0 0 0 0 3 0 37 7 11 6 6 6 6 6 6 6 6 6 6 6 6 6 6 6 6 6 6 6 6 6 6 6 12 7 7 7 36 0 0 0 3 0 3 3 0 0 3 3 0 34 9 14 6 6 6 6 
6 6 6 6 6 6 6 6 6 6 6 6 13 9 35 0 0 0 0 3 0 0 2 1 0 3 0 0 0 3 0 3 0 0 3 3 1 0 0 0 0 0 0 0 37 7 7 7 7 7 11 6 6 6 6 6 6 6 6 6 6 6 6 6 6 6 6 6 6 6 6 6 6 6 6 6 6 6 6 6 12 7 36 0 3 0 3 0 0 3 0 0 3 0 0 34 14 6 6 6 
6 6 6 6 6 6 6 6 6 6 13 9 35 0 0 0 0 0 0 0 0 3 0 0 0 0 0 3 0 0 0 0 0 0 0 2 3 0 0 0 0 3 0 0 34 14 6 6 6 6 6 6 6 6 6 6 6 6 6 6 6 6 6 6 6 6 6 6 6 6 6 6 6 6 6 6 6 6 6 6 6 6 12 36 0 0 0 0 2 0 0 0 0 3 0 0 10 6 6 6 
6 6 6 6 6 6 6 6 6 6 8 0 0 0 3 2 0 3 0 0 0 0 0 0 0 0 0 0 3 0 3 0 1 0 0 0 0 0 0 3 0 0 0 0 0 34 9 9 14 6 6 6 6 6 6 6 6 6 6 6 6 6 6 6 6 6 6 6 6 6 6 6 6 6 6 6 6 6 6 6 6 6 6 12 36 0 0 3 0 0 3 3 0 0 3 0 34 14 6 6 
6 6 6 6 6 6 6 6 6 13 35 0 0 0 0 0 0 0 3 0 0 0 0 0 3 0 0 0 0 0 0 0 2 3 0 0 0 3 0 0 3 0 0 0 0 0 0 0 34 9 9 9 14 6 6 6 6 6 6 6 6 13 9 9 9 9 9 14 6 6 6 6 6 6 6 6 6 6 6 6 6 6 6 6 12 7 36 0 0 3 3 0 3 2 3 2 0 10 6 6 
6 6 6 6 6 6 6 6 6 8 0 0 0 0 0 0 1 0 0 2 3 0 3 0 1 0 0 3 0 0 3 0 0 3 0 0 0 0 0 0 0 0 0 3 0 3 0 0 0 0 3 3 34 9 9 14 6 6 6 6 13 35 0 0 0 0 0 34 9 14 6 6 6 6 6 6 6 6 6 6 6 6 6 6 6 6 12 36 3 0 0 0 0 3 3 0 0 10 6 6 
6 6 6 6 6 6 6 6 6 8 0 0 1 3 0 0 0 3 0 2 3 0 0 0 0 0 0 0 0 0 0 0 0 2 0 0 3 0 3 0 0 0 0 0 2 0 0 3 0 3 0 0 0 0 0 34 9 9 9 9 35 3 3 0 0 39 24 24 40 34 9 14 6 6 6 6 6 6 6 6 6 6 6 6 6 6 6 12 7 36 0 3 0 0 0 0 3 10 6 6 
6 6 6 6 6 6 6 6 6 8 0 0 0 0 0 0 0 0 0 0 0 0 0 3 0 0 0 0 3 0 3 0 0 3 0 3 0 0 1 0 0 3 0 0 3 0 0 0 0 0 0 1 3 3 3 0 3 2 0 3 0 0 0 0 0 23 22 22 27 24 40 34 14 6 6 6 6 6 6 6 6 6 6 6 6 6 6 6 6 8 2 0 3 3 3 0 0 10 6 6 
6 6 6 6 6 6 6 6 6 12 36 0 0 0 0 3 0 0 0 3 3 0 3 0 0 3 2 2 0 0 0 0 0 0 3 0 0 3 0 0 0 0 1 0 0 0 0 0 0 0 0 0 0 0 3 0 3 0 3 0 0 2 3 0 39 30 22 22 22 22 27 40 34 14 6 6 6 6 6 6 6 6 6 6 6 6 6 6 6 8 0 0 0 0 3 2 0 10 6 6 
6 6 6 6 6 6 6 6 6 6 12 36 0 0 0 0 1 3 0 0 0 0 0 0 0 0 0 1 0 0 0 0 0 0 0 0 0 0 0 18 16 16 16 16 16 16 16 16 16 16 16 17 0 0 0 3 0 3 0 3 0 0 0 0 23 22 22 22 22 22 22 27 40 34 9 14 6 6 6 6 6 6 6 6 6 6 6 6 6 12 36 0 3 0 0 0 37 11 6 6 
6 6 6 6 6 6 6 6 6 6 6 12 7 36 0 0 0 3 0 0 3 2 0 0 0 0 3 0 0 3 3 0 0 0 0 3 0 0 18 21 0 0 0 0 0 0 1 0 0 1 0 19 17 1 0 2 0 0 3 0 3 0 0 0 23 22 22 22 22 22 22 22 27 24 40 34 14 6 6 6 6 6 6 6 6 6 6 6 6 6 8 0 0 0 3 37 11 6 6 6 
6 6 6 6 6 6 6 6 6 6 6 6 6 12 7 36 0 0 0 0 0 0 0 3 0 0 0 0 0 0 0 0 0 3 0 2 0 18 21 0 0 0 0 3 0 3 0 0 0 3 0 2 19 17 0 0 1 0 1 0 0 1 0 0 23 22 22 22 22 22 22 22 22 22 27 40 34 14 6 6 6 6 6 6 6 6 6 6 6 6 8 0 3 0 37 11 6 6 6 6 
6 6 6 6 6 6 6 6 6 6 6 6 6 6 6 12 7 36 0 0 0 3 0 0 0 0 3 0 0 0 3 0 0 0 0 0 18 21 0 0 0 3 2 0 3 1 0 3 0 0 3 0 0 19 16 16 16 16 17 0 3 0 0 3 42 29 22 22 22 22 22 22 22 22 22 27 40 34 9 14 6 6 6 6 6 6 6 6 6 6 12 7 7 7 11 6 6 6 6 6 
6 6 6 6 6 6 6 6 6 6 6 6 6 6 6 6 6 12 36 0 0 0 0 0 0 0 2 0 3 0 0 0 3 0 0 18 21 0 0 1 0 0 0 0 0 0 3 0 0 1 3 0 1 0 0 0 0 0 15 0 0 0 0 0 0 23 22 22 22 22 22 22 22 22 22 22 27 24 40 34 14 6 6 6 6 6 6 6 6 6 6 6 6 6 6 6 6 6 6 6 
6 6 6 6 6 6 6 6 6 6 6 6 6 6 6 6 6 6 12 36 0 0 0 3 3 0 0 0 0 3 0 0 0 0 18 21 0 0 3 0 0 0 0 3 1 0 0 3 0 0 0 3 3 0 0 1 0 0 15 1 0 3 0 2 0 42 29 22 22 22 22 22 22 22 22 22 22 22 27 40 34 9 14 6 6 6 6 6 6 6 6 6 6 6 6 6 6 6 6 6 
6 6 6 6 6 6 6 6 6 6 6 6 6 6 6 6 6 6 6 12 36 0 0 0 0 0 0 0 3 2 0 3 0 18 21 0 0 3 3 0 3 3 0 3 0 3 0 0 0 0 0 0 0 0 0 3 0 0 15 0 0 0 0 0 0 0 23 22 22 22 22 22 22 22 22 22 22 22 22 27 24 40 34 9 9 14 6 6 6 6 6 6 6 6 6 6 6 6 6 6 
6 6 6 6 6 6 6 6 6 6 6 6 6 6 6 6 6 6 6 6 12 7 36 0 0 0 3 3 0 0 3 0 0 15 0 0 3 3 2 0 0 0 0 0 0 0 0 3 3 3 1 0 0 3 0 0 0 0 19 16 16 16 16 16 16 16 31 22 22 22 22 22 22 22 22 22 22 22 22 22 22 27 24 24 40 34 9 9 9 9 9 14 6 6 6 6 6 6 6 6 
6 6 6 6 6 6 6 6 6 6 6 6 6 6 6 6 6 6 6 6 6 6 12 36 0 0 0 0 3 0 0 0 0 15 0 0 0 3 0 3 0 0 3 0 0 0 3 3 0 3 3 3 0 0 0 3 0 0 0 0 1 0 0 0 3 0 23 22 22 22 22 22 22 22 22 22 22 22 22 22 22 22 22 28 41 0 3 0 0 0 0 34 6 6 6 6 6 6 6 6 
6 6 6 6 6 6 6 6 6 6 6 6 6 6 6 6 6 6 6 6 6 6 6 6 36 0 0 0 3 0 0 3 0 15 0 3 3 3 3 3 0 3 3 0 3 0 3 3 0 0 0 3 3 0 3 3 3 3 3 0 0 3 0 0 0 0 23 22 22 22 22 22 22 22 22 22 22 22 22 22 22 22 22 25 0 0 0 0 0 0 0 0 10 6 6 6 6 6 6 6 
6 6 6 6 6 6 6 6 6 6 6 6 6 6 6 6 6 6 6 6 6 6 6 6 12 7 36 1 0 0 2 0 0 15 0 0 3 0 3 3 0 0 3 3 3 0 3 0 2 0 3 0 0 3 0 0 3 0 3 0 0 0 0 1 0 0 42 29 22 22 22 22 22 22 22 22 22 22 22 22 22 22 28 41 0 0 0 0 0 0 3 0 10 6 6 6 6 6 6 6 
6 6 6 6 6 6 6 6 6 6 6 6 6 6 6 6 6 6 6 6 6 6 6 6 6 6 12 36 0 0 0 0 0 15 0 0 2 0 3 3 3 3 3 3 0 3 0 0 3 0 3 0 0 0 3 0 3 1 3 3 3 0 0 0 0 3 0 42 26 26 29 22 22 22 22 22 22 22 22 22 22 22 25 0 0 3 3 0 0 0 0 37 11 6 6 6 6 6 6 6 
6 6 6 6 6 6 6 6 6 6 6 6 6 6 6 6 6 6 6 6 6 6 6 6 6 6 6 12 36 3 3 0 0 19 16 17 0 0 0 0 0 0 0 3 3 0 0 0 3 0 0 0 0 0 3 3 2 3 3 0 3 3 3 3 0 0 0 0 0 3 42 26 26 26 26 26 26 29 22 22 28 26 41 0 0 0 0 0 0 0 0 10 6 6 6 6 6 6 6 6 
6 6 6 6 6 6 6 6 6 6 6 6 6 6 6 6 6 6 6 6 6 6 6 6 6 6 6 6 12 7 36 0 3 0 0 19 16 16 16 17 0 0 0 0 0 0 3 3 0 0 0 2 0 3 0 3 0 3 0 0 3 3 0 3 3 3 3 3 0 3 3 3 0 0 3 0 0 42 26 26 41 0 0 0 3 0 0 3 0 37 7 11 6 6 6 6 6 6 6 6 
6 6 6 6 6 6 6 6 6 6 6 6 6 6 6 6 6 6 6 6 6 6 6 6 6 6 6 6 6 6 12 7 7 36 0 2 0 0 0 19 16 16 16 16 17 0 0 0 0 3 3 3 3 3 3 0 0 3 0 3 3 0 3 0 3 0 3 3 3 3 0 0 0 0 3 0 0 0 0 0 0 3 0 0 0 0 0 0 37 11 6 6 6 6 6 6 6 6 6 6 
6 6 6 6 6 6 6 6 6 6 6 6 6 6 6 6 6 6 6 6 6 6 6 6 6 6 6 6 6 6 6 6 6 12 7 7 7 36 1 0 0 0 0 0 19 16 16 16 16 16 17 0 0 3 0 0 3 0 0 0 0 0 3 0 0 3 3 0 0 3 0 0 3 3 3 0 0 3 0 0 0 0 0 3 0 0 37 7 11 6 6 6 6 6 6 6 6 6 6 6 
6 6 6 6 6 6 6 6 6 6 6 6 6 6 6 6 6 6 6 6 6 6 6 6 6 6 6 6 6 6 6 6 6 6 6 6 6 12 7 36 0 0 0 0 0 1 0 0 0 0 19 17 0 3 0 0 0 0 0 0 0 0 0 3 3 0 2 0 3 3 3 0 0 3 0 0 3 0 0 0 3 0 0 0 0 0 10 6 6 6 6 6 6 6 6 6 6 6 6 6 
6 6 6 6 6 6 6 6 6 6 6 6 6 6 6 6 6 6 6 6 6 6 6 6 6 6 6 6 6 6 6 6 6 6 6 6 6 6 6 12 7 36 3 0 0 0 0 0 0 0 0 19 17 0 0 0 0 0 2 0 0 1 0 0 0 0 0 0 0 3 0 0 3 0 2 0 0 0 0 3 0 0 3 0 0 37 11 6 6 6 6 6 6 6 6 6 6 6 6 6 
6 6 6 6 6 6 6 6 6 6 6 6 6 6 6 6 6 6 6 13 9 9 9 9 9 9 9 9 14 6 6 6 6 6 6 6 6 6 6 6 6 12 7 7 36 3 0 3 0 0 0 0 19 17 0 0 0 0 0 0 0 0 0 0 0 0 0 0 0 0 0 3 3 0 0 0 3 0 0 0 0 1 0 0 37 11 6 6 6 6 6 6 6 6 6 6 6 6 6 6 
6 6 6 6 6 6 6 6 6 6 6 6 6 6 6 6 13 9 9 35 0 0 0 0 0 0 0 0 34 9 14 6 6 6 6 6 6 6 6 6 6 6 6 6 12 7 7 36 0 0 2 0 0 19 16 16 16 16 16 16 16 16 16 16 16 16 16 16 17 0 0 0 0 0 3 0 0 3 3 0 0 0 0 37 11 6 6 6 6 6 6 6 6 6 6 6 6 6 6 6 
6 6 6 6 6 6 6 6 6 6 6 6 6 6 6 13 35 0 0 0 0 0 0 0 0 0 0 3 0 3 34 9 14 6 6 6 6 6 6 6 6 6 6 6 6 6 6 12 7 36 0 0 0 0 0 0 0 0 0 0 0 0 0 0 0 0 0 0 19 17 0 0 0 0 3 0 0 0 0 1 0 3 37 11 6 6 6 6 6 6 6 6 6 6 6 6 6 6 6 6 
6 6 6 6 6 6 6 6 6 6 6 6 6 13 9 35 0 0 0 0 0 0 0 0 0 0 0 0 0 0 0 0 34 9 9 14 6 6 6 6 6 6 6 6 6 6 6 6 6 12 7 7 7 7 7 36 0 0 0 0 0 0 1 0 0 2 0 0 0 19 17 0 3 0 0 0 3 0 0 0 0 0 10 6 6 6 6 6 6 6 6 6 6 6 6 6 6 6 6 6 
6 6 6 6 6 6 6 6 6 6 6 6 13 35 0 0 0 0 0 0 0 0 0 3 0 0 0 0 0 0 0 3 0 3 3 10 6 6 6 6 6 6 6 6 6 6 6 6 6 6 6 6 6 6 6 12 7 36 0 0 0 0 0 0 0 0 0 0 3 0 19 17 0 0 2 0 0 3 0 3 3 0 10 6 6 6 6 6 6 6 6 6 6 6 6 6 6 6 6 6 
6 6 6 6 6 6 6 6 6 6 6 13 35 0 0 1 0 0 0 0 1 0 0 0 5 0 0 0 0 0 0 0 3 0 0 34 9 9 14 6 6 6 6 6 6 6 6 6 6 6 6 6 6 6 6 6 6 12 7 36 0 0 0 3 2 3 3 0 0 0 0 19 17 0 0 0 0 3 3 0 0 37 11 6 6 6 6 6 6 6 6 6 6 6 6 6 6 6 6 6 
6 6 6 6 6 6 6 6 6 6 6 8 3 0 0 0 0 3 0 0 0 0 0 0 15 0 0 1 0 0 0 1 0 3 0 0 3 0 34 9 14 6 6 6 6 6 6 6 6 6 6 6 6 6 6 6 6 6 6 12 7 7 7 36 0 0 0 0 3 0 0 0 19 17 0 0 1 0 0 0 0 10 6 6 6 6 6 6 6 6 6 6 6 6 6 6 6 6 6 6 
6 6 6 6 6 6 6 6 6 6 13 35 1 1 0 0 0 0 0 0 0 0 0 0 15 0 0 0 0 0 0 0 0 3 0 0 0 3 0 0 34 9 14 6 6 6 6 6 6 6 6 6 6 6 6 6 6 6 6 6 6 6 6 12 7 7 36 3 0 0 1 0 0 15 0 0 0 3 0 0 37 11 6 6 6 6 6 6 6 6 6 6 6 6 6 6 6 6 6 6 
6 6 6 6 6 6 6 6 6 6 8 0 0 0 0 2 0 0 0 5 2 0 0 0 15 0 0 0 0 3 0 0 0 0 0 3 0 3 0 3 0 0 34 9 14 6 6 6 6 6 6 6 6 6 6 6 6 6 6 6 6 6 6 6 6 6 8 3 0 0 3 0 0 15 0 3 0 3 0 3 10 6 6 6 6 6 6 6 6 6 6 6 6 6 6 6 6 6 6 6 
6 6 6 6 6 6 6 6 6 13 35 0 0 0 0 0 0 0 0 15 0 0 0 0 15 0 2 0 0 0 0 0 0 0 0 0 3 0 0 3 0 3 0 0 34 14 6 6 6 6 6 6 6 6 6 6 6 6 6 6 6 6 6 6 6 6 12 36 1 0 0 0 0 15 0 0 2 0 0 37 6 6 6 6 6 6 6 6 6 6 6 6 6 6 6 6 6 6 6 6 
6 6 6 6 6 6 6 6 6 8 0 0 0 0 0 4 16 16 16 20 16 16 16 16 20 16 16 16 16 16 16 17 0 0 1 0 0 2 0 0 0 0 0 0 0 34 9 14 6 6 6 6 6 6 6 6 6 6 6 6 6 6 6 6 6 6 6 12 36 0 3 0 0 15 3 0 3 0 0 10 6 6 6 6 6 6 6 6 6 6 6 6 6 6 6 6 6 6 6 6 
6 6 6 6 6 6 6 6 6 8 0 0 0 2 0 0 0 0 0 15 0 0 0 0 15 0 0 0 0 0 0 15 0 0 0 0 0 3 0 0 3 0 3 0 3 0 0 34 9 14 6 6 6 6 6 6 6 6 6 6 6 6 6 6 6 6 6 6 12 36 0 3 0 15 0 0 3 0 37 11 6 6 6 6 6 6 6 6 6 6 6 6 6 6 6 6 6 6 6 6 
6 6 6 6 6 6 6 6 6 8 0 0 0 3 0 0 0 0 0 15 0 0 0 0 15 0 0 1 0 0 0 15 0 0 0 0 3 3 3 0 3 0 3 3 0 3 0 3 0 34 9 9 14 6 6 6 6 6 6 6 6 6 6 6 6 6 6 6 6 12 36 0 2 15 0 0 37 7 11 6 6 6 6 6 6 6 6 6 6 6 6 6 6 6 6 6 6 6 6 6 
6 6 6 6 6 6 6 6 6 8 0 0 1 0 0 0 1 0 0 15 0 0 0 0 15 0 0 0 0 0 0 15 0 0 0 0 0 0 3 0 3 3 3 3 3 3 1 3 0 3 3 3 34 9 9 9 9 9 9 9 9 9 9 9 9 9 9 9 14 6 12 36 0 15 0 0 10 6 6 6 6 6 6 6 6 6 6 6 6 6 6 6 6 6 6 6 6 6 6 6 
6 6 6 6 6 6 6 6 6 8 0 0 0 0 0 0 0 0 0 38 0 1 0 0 15 0 0 0 0 0 0 15 0 0 0 1 0 0 3 3 3 1 3 3 3 0 3 3 3 0 3 0 0 3 1 0 3 3 3 3 0 0 0 0 3 0 0 3 34 9 14 12 7 45 7 7 11 6 6 6 6 6 6 6 6 6 6 6 6 6 6 6 6 6 6 6 6 6 6 6
6 6 6 6 6 6 6 6 6 8 0 0 0 0 0 0 0 0 0 0 0 0 0 0 15 0 0 0 0 0 0 15 0 0 0 0 0 3 0 0 3 3 3 3 0 3 3 3 3 3 3 3 3 0 3 0 3 0 3 0 3 3 0 1 0 3 0 0 0 3 34 9 9 46 14 6 6 6 6 6 6 6 6 6 6 6 6 6 6 6 6 6 6 6 6 6 6 6 6 6
6 6 6 6 6 6 6 6 6 8 0 0 0 0 0 3 0 0 0 0 0 0 0 0 38 0 0 0 0 0 0 15 0 0 0 0 0 0 0 0 3 3 3 3 3 3 0 3 3 3 0 0 3 3 3 3 0 3 0 3 3 0 3 0 0 3 0 3 2 0 0 0 18 21 34 14 6 6 6 6 6 6 6 6 6 6 6 6 6 6 6 6 6 6 6 6 6 6 6 6 
6 6 6 6 6 6 6 6 6 12 36 0 0 0 0 0 0 0 0 0 1 0 0 0 0 0 0 0 1 0 0 15 2 0 0 0 0 0 3 3 0 3 0 1 0 0 3 0 1 0 3 3 0 3 3 3 0 3 3 3 3 0 0 3 0 1 0 0 0 0 0 18 21 0 1 34 9 14 6 6 6 6 6 6 6 6 6 6 6 6 6 6 6 6 6 6 6 6 6 6 
6 6 6 6 6 6 6 6 6 6 8 0 3 0 0 0 0 0 3 0 0 0 0 0 0 0 1 0 0 0 0 15 0 0 0 0 1 0 0 3 3 0 3 0 3 3 3 3 3 3 3 0 3 0 3 0 0 3 0 0 0 0 0 0 2 0 0 0 3 0 18 21 0 3 0 3 0 34 9 9 14 6 6 6 6 6 6 6 6 6 6 6 6 6 6 6 6 6 6 6 
6 6 6 6 6 6 6 6 6 6 8 0 0 0 0 0 0 0 0 0 0 0 3 0 0 0 0 0 0 0 0 15 0 0 0 0 0 0 0 3 0 3 0 3 0 3 0 3 0 3 0 3 0 3 0 18 16 16 16 16 16 16 16 16 16 16 16 16 16 16 21 3 0 0 0 0 3 1 0 0 34 14 6 6 6 6 6 6 6 6 6 6 6 6 6 6 6 6 6 6 
6 6 6 6 6 6 6 6 6 6 8 0 0 0 0 0 0 0 0 0 0 0 0 0 0 0 4 16 16 16 16 20 16 16 16 16 17 0 0 3 3 0 1 0 3 3 3 0 3 0 0 3 0 0 18 21 2 0 0 0 3 0 0 0 0 3 0 0 0 0 3 0 2 3 0 3 0 0 3 0 0 34 14 6 6 6 6 6 6 6 6 6 6 6 6 6 6 6 6 6 
6 6 6 6 6 6 6 6 6 6 12 36 0 0 3 0 0 0 0 0 0 0 0 0 0 0 0 0 0 0 0 15 0 0 0 0 15 0 0 3 3 0 3 3 3 0 0 0 0 0 0 0 0 18 21 0 0 0 3 0 0 3 3 3 3 0 0 3 0 3 3 0 3 0 1 0 3 0 0 0 0 0 10 6 6 6 6 6 6 6 6 6 6 6 6 6 6 6 6 6 
6 6 6 6 6 6 6 6 6 6 6 12 36 0 0 0 0 0 0 3 0 0 0 0 0 0 0 0 0 0 0 15 0 0 0 0 15 0 0 3 3 3 0 0 3 3 3 0 3 0 3 0 18 21 0 0 3 0 0 3 0 0 3 0 3 3 0 0 3 3 3 0 3 0 3 3 0 0 3 0 3 3 34 14 6 6 6 6 6 6 6 6 6 6 6 6 6 6 6 6 
6 6 6 6 6 6 6 6 6 6 6 6 12 36 0 0 0 0 0 0 0 0 0 3 0 0 0 0 0 0 0 15 0 0 0 0 38 0 0 0 3 3 3 0 3 3 0 2 0 0 0 18 21 0 0 3 3 3 0 2 3 3 3 3 3 0 2 3 0 0 0 1 3 0 0 0 3 0 0 2 0 3 0 10 6 6 6 6 6 6 6 6 6 6 6 6 6 6 6 6 
6 6 6 6 6 6 6 6 6 6 6 6 6 8 0 0 0 0 0 0 0 0 0 0 0 0 0 0 1 0 0 15 0 0 0 0 0 3 0 3 0 0 2 0 0 0 3 0 3 0 18 21 0 3 3 0 3 3 0 0 3 0 3 3 0 3 0 3 3 0 3 3 3 0 1 0 0 0 3 0 0 0 2 10 6 6 6 6 6 6 6 6 6 6 6 6 6 6 6 6 
6 6 6 6 6 6 6 6 6 6 6 6 6 12 36 0 0 3 0 0 0 0 0 0 0 0 3 0 0 0 0 15 0 0 0 0 1 0 0 3 0 3 0 3 0 0 3 0 0 18 21 3 3 3 0 3 3 3 0 3 3 0 37 7 7 7 7 7 7 7 7 36 0 1 3 0 0 3 0 3 3 0 0 10 6 6 6 6 6 6 6 6 6 6 6 6 6 6 6 6 
6 6 6 6 6 6 6 6 6 6 6 6 6 6 12 36 0 0 0 0 0 3 0 0 0 0 0 0 0 0 0 15 0 0 0 3 0 2 0 3 0 0 3 3 0 3 0 0 18 21 0 0 0 3 0 3 0 3 3 0 37 7 11 6 6 6 6 6 6 6 6 12 7 36 0 3 0 3 3 0 0 1 0 34 14 6 6 6 6 6 6 6 6 6 6 6 6 6 6 6 
6 6 6 6 6 6 6 6 6 6 6 6 6 6 6 12 36 0 0 0 0 0 0 0 0 0 0 0 0 2 0 15 0 0 0 0 0 0 3 0 3 0 3 3 3 3 0 18 21 3 0 3 3 0 3 0 2 0 37 7 11 6 6 6 6 6 6 6 6 6 6 6 6 12 36 0 0 3 0 3 0 3 0 0 10 6 6 6 6 6 6 6 6 6 6 6 6 6 6 6 
6 6 6 6 6 6 6 6 6 6 6 6 6 6 6 6 12 36 0 0 0 0 0 3 0 0 0 0 3 0 0 19 16 16 16 16 16 16 16 16 16 16 16 16 16 16 16 21 0 0 0 3 0 0 0 3 37 7 11 6 6 6 6 6 6 6 6 6 6 6 6 6 6 6 8 0 0 3 3 0 2 0 3 0 10 6 6 6 6 6 6 6 6 6 6 6 6 6 6 6 
6 6 6 6 6 6 6 6 6 6 6 6 6 6 6 6 6 12 7 36 0 0 0 0 0 0 0 0 0 0 0 0 0 0 0 0 0 0 3 0 0 0 0 3 0 2 0 0 0 3 0 3 3 0 37 7 11 6 6 6 6 6 6 6 6 6 6 6 6 6 6 6 6 6 8 0 0 0 3 1 0 0 0 3 10 6 6 6 6 6 6 6 6 6 6 6 6 6 6 6 
6 6 6 6 6 6 6 6 6 6 6 6 6 6 6 6 6 6 6 12 7 36 0 0 0 3 0 3 0 0 0 0 0 0 2 0 0 3 0 3 2 3 0 0 3 0 3 0 3 0 3 0 3 37 11 6 6 6 6 6 6 6 6 6 6 6 6 6 6 6 6 6 6 6 8 3 1 3 0 0 3 0 0 0 10 6 6 6 6 6 6 6 6 6 6 6 6 6 6 6 
6 6 6 6 6 6 6 6 6 6 6 6 6 6 6 6 6 6 6 6 6 12 36 0 0 0 0 0 0 3 0 0 0 3 0 0 3 3 0 3 0 3 0 3 0 3 3 2 3 3 37 7 7 11 6 6 6 6 6 6 6 6 6 6 6 6 6 6 6 6 6 6 6 6 8 3 0 0 0 0 2 3 0 0 10 6 6 6 6 6 6 6 6 6 6 6 6 6 6 6 
6 6 6 6 6 6 6 6 6 6 6 6 6 6 6 6 6 6 6 6 6 6 12 7 7 36 0 0 0 0 0 3 0 0 0 3 3 0 3 3 3 0 3 3 0 3 0 3 37 7 11 6 6 6 6 6 6 6 6 6 6 6 6 6 6 6 6 6 6 6 6 6 6 13 35 0 0 0 3 0 0 3 0 0 10 6 6 6 6 6 6 6 6 6 6 6 6 6 6 6 
6 6 6 6 6 6 6 6 6 6 6 6 6 6 6 6 6 6 6 6 6 6 6 6 6 12 7 7 7 36 0 0 0 0 0 0 0 0 3 3 0 3 0 0 3 37 7 7 11 6 6 6 6 6 6 6 6 6 6 6 6 6 6 6 6 6 6 6 6 6 6 6 13 35 0 0 0 3 3 3 0 0 0 37 11 6 6 6 6 6 6 6 6 6 6 6 6 6 6 6 
6 6 6 6 6 6 6 6 6 6 6 6 6 6 6 6 6 6 6 6 6 6 6 6 6 6 6 6 6 12 7 7 7 7 7 7 7 7 7 7 7 7 7 7 7 11 6 6 6 6 6 6 6 6 6 6 6 6 6 6 6 6 6 6 6 6 6 6 6 6 13 9 35 0 0 1 3 3 0 0 3 0 0 10 6 6 6 6 6 6 6 6 6 6 6 6 6 6 6 6 
6 6 6 6 6 6 6 6 6 6 6 6 6 6 6 6 6 6 6 6 6 6 6 6 6 6 6 6 6 6 6 6 6 6 12 6 6 6 6 6 6 6 6 6 6 6 6 6 6 6 6 6 6 6 6 6 6 6 6 6 6 6 6 6 6 6 6 6 6 13 35 0 0 3 3 0 3 3 0 0 1 0 37 11 6 6 6 6 6 6 6 6 6 6 6 6 6 6 6 6 
6 6 6 6 6 13 9 9 9 9 14 6 6 6 6 6 6 6 6 6 6 6 6 6 6 6 6 6 6 6 6 6 6 6 6 6 6 6 6 6 6 6 6 6 6 6 6 6 6 6 6 6 6 6 6 13 9 9 9 9 14 6 6 6 6 6 6 6 13 35 0 0 3 3 0 1 1 0 0 0 0 37 11 6 6 6 6 6 6 6 6 6 6 6 6 6 6 6 6 6 
6 6 6 6 6 8 0 1 0 3 34 14 6 6 6 6 6 6 6 6 6 6 6 6 6 6 6 6 6 6 6 6 6 6 6 6 6 6 6 6 6 6 6 6 6 6 6 6 6 6 6 6 6 6 13 35 0 0 3 3 34 14 6 13 9 9 9 9 35 0 0 3 3 0 0 0 2 0 3 0 37 11 6 6 6 6 6 6 6 6 6 6 6 6 6 6 6 6 6 6 
6 6 6 6 6 12 36 0 0 0 0 34 9 14 6 6 6 6 6 6 6 6 6 6 6 6 6 6 6 6 6 6 6 6 6 6 6 6 6 6 6 6 6 6 6 6 6 6 6 6 6 6 6 13 35 3 3 0 0 0 0 34 9 35 0 0 0 0 0 3 0 0 3 0 3 0 0 3 0 37 11 6 6 6 6 6 6 6 6 6 6 6 6 6 6 6 6 6 6 6 
6 6 6 6 6 6 12 36 0 3 0 0 0 34 9 14 6 6 6 6 6 6 6 13 9 9 9 14 6 6 6 6 6 6 6 6 6 6 6 6 6 6 6 6 6 6 6 6 6 6 6 6 6 8 0 3 1 3 2 3 0 0 0 0 0 3 0 3 3 3 0 0 3 0 0 3 0 0 37 11 6 6 6 6 6 6 6 6 6 6 6 6 6 6 6 6 6 6 6 6 
6 6 6 6 6 6 6 12 36 0 0 3 0 0 0 34 9 9 9 14 6 6 9 35 0 0 1 34 9 9 9 9 9 9 9 9 9 9 6 6 6 6 6 6 6 6 6 6 6 6 6 6 6 8 0 3 0 3 3 3 0 2 0 2 1 3 0 0 1 0 0 2 0 0 0 0 37 7 11 6 6 6 6 6 6 6 6 6 6 6 6 6 6 6 6 6 6 6 6 6 
6 6 6 6 6 6 6 6 12 7 36 0 2 3 2 3 0 0 3 34 9 35 0 0 3 0 3 0 0 0 0 0 3 0 0 0 3 1 34 14 6 6 6 6 6 6 6 6 6 6 6 6 6 12 36 0 0 3 0 0 3 0 0 0 0 0 3 3 3 3 1 0 3 0 37 7 11 6 6 6 6 6 6 6 6 6 6 6 6 6 6 6 6 6 6 6 6 6 6 6 
6 6 6 6 6 6 6 6 6 6 8 3 0 0 0 0 3 2 3 0 0 0 1 0 1 0 0 3 0 3 0 3 0 3 0 0 0 0 0 10 6 6 6 6 6 6 6 6 6 6 6 6 6 6 12 36 0 0 0 0 0 0 3 3 3 3 0 1 0 0 0 0 37 7 11 6 6 6 6 6 6 6 6 6 6 6 6 6 6 6 6 6 6 6 6 6 6 6 6 6 
6 6 6 6 6 6 6 6 6 6 12 7 7 7 36 0 3 0 0 0 0 3 0 0 0 3 3 0 0 0 2 3 0 0 2 1 0 3 0 10 6 6 6 6 6 6 6 6 6 6 6 6 6 6 6 12 7 7 7 7 7 36 0 0 3 0 0 3 37 7 7 7 11 6 6 6 6 6 6 6 6 6 6 6 6 6 6 6 6 6 6 6 6 6 6 6 6 6 6 6 
6 6 6 6 6 6 6 6 6 6 6 6 6 6 12 7 36 0 3 0 1 0 0 3 0 0 0 3 0 0 3 1 1 0 3 0 0 0 3 10 6 6 6 6 6 6 6 6 6 6 6 6 6 6 6 6 6 6 6 6 6 12 7 7 7 7 7 7 11 6 6 6 6 6 6 6 6 6 6 6 6 6 6 6 6 6 6 6 6 6 6 6 6 6 6 6 6 6 6 6 
6 6 6 6 6 6 6 6 6 6 6 6 6 6 6 6 12 7 7 7 7 7 7 7 7 36 0 0 1 0 3 0 2 0 0 0 0 37 7 11 6 6 6 6 6 6 6 6 6 6 6 6 6 6 6 6 6 6 6 6 6 6 6 6 6 6 6 6 6 6 6 6 6 6 6 6 6 6 6 6 6 6 6 6 6 6 6 6 6 6 6 6 6 6 6 6 6 6 6 6 
6 6 6 6 6 6 6 6 6 6 6 6 6 6 6 6 6 6 6 6 6 6 6 6 6 12 7 7 36 0 0 0 0 3 0 0 37 11 6 6 6 6 6 6 6 6 6 6 6 6 6 6 6 6 6 6 6 6 6 6 6 6 6 6 6 6 6 6 6 6 6 6 6 6 6 6 6 6 6 6 6 6 6 6 6 6 6 6 6 6 6 6 6 6 6 6 6 6 6 6 
6 6 6 6 6 6 6 6 6 6 6 6 6 6 6 6 6 6 6 6 6 6 6 6 6 6 6 6 6 7 7 7 7 7 7 7 11 6 6 6 6 6 6 6 6 6 6 6 6 6 6 6 6 6 6 6 6 6 6 6 6 6 6 6 6 6 6 6 6 6 6 6 6 6 6 6 6 6 6 6 6 6 6 6 6 6 6 6 6 6 6 6 6 6 6 6 6 6 6 6 
6 6 6 6 6 6 6 6 6 6 6 6 6 6 6 6 6 6 6 6 6 6 6 6 6 6 6 6 6 6 6 6 6 6 6 6 6 6 6 6 6 6 6 6 6 6 6 6 6 6 6 6 6 6 6 6 6 6 6 6 6 6 6 6 6 6 6 6 6 6 6 6 6 6 6 6 6 6 6 6 6 6 6 6 6 6 6 6 6 6 6 6 6 6 6 6 6 6 6 6 
6 6 6 6 6 6 6 6 6 6 6 6 6 6 6 6 6 6 6 6 6 6 6 6 6 6 6 6 6 6 6 6 6 6 6 6 6 6 6 6 6 6 6 6 6 6 6 6 6 6 6 6 6 6 6 6 6 6 6 6 6 6 6 6 6 6 6 6 6 6 6 6 6 6 6 6 6 6 6 6 6 6 6 6 6 6 6 6 6 6 6 6 6 6 6 6 6 6 6 6 
6 6 6 6 6 6 6 6 6 6 6 6 6 6 6 6 6 6 6 6 6 6 6 6 6 6 6 6 6 6 6 6 6 6 6 6 6 6 6 6 6 6 6 6 6 6 6 6 6 6 6 6 6 6 6 6 6 6 6 6 6 6 6 6 6 6 6 6 6 6 6 6 6 6 6 6 6 6 6 6 6 6 6 6 6 6 6 6 6 6 6 6 6 6 6 6 6 6 6 6 
6 6 6 6 6 6 6 6 6 6 6 6 6 6 6 6 6 6 6 6 6 6 6 6 6 6 6 6 6 6 6 6 6 6 6 6 6 6 6 6 6 6 6 6 6 6 6 6 6 6 6 6 6 6 6 6 6 6 6 6 6 6 6 6 6 6 6 6 6 6 6 6 6 6 6 6 6 6 6 6 6 6 6 6 6 6 6 6 6 6 6 6 6 6 6 6 6 6 6 6 
6 6 6 6 6 6 6 6 6 6 6 6 6 6 6 6 6 6 6 6 6 6 6 6 6 6 6 6 6 6 6 6 6 6 6 6 6 6 6 6 6 6 6 6 6 6 6 6 6 6 6 6 6 6 6 6 6 6 6 6 6 6 6 6 6 6 6 6 6 6 6 6 6 6 6 6 6 6 6 6 6 6 6 6 6 6 6 6 6 6 6 6 6 6 6 6 6 6 6 6 
