0 0 0 0 0 0 0 0 0 7 0 0 0 1 0 0
0 7 0 0 0 0 0 0 0 0 0 0 7 1 0 0
0 0 0 0 0 7 0 0 0 0 8 0 0 1 0 0
0 0 0 0 0 0 0 0 0 0 0 0 0 1 0 0
0 8 0 4 2 2 2 2 2 2 2 2 2 6 0 0
0 0 0 1 0 0 7 0 0 0 0 0 0 0 0 0
7 0 0 1 0 0 0 0 0 0 0 0 0 7 0 0
0 0 0 1 0 8 7 0 0 0 0 0 0 0 0 7
0 0 0 1 0 0 0 0 0 0 7 0 0 0 0 0
0 0 0 1 0 0 0 0 0 0 0 0 0 8 0 7
0 7 0 1 0 0 0 0 0 0 7 0 0 0 0 0
0 0 0 1 0 7 0 0 0 0 0 0 0 0 0 0
0 0 0 1 0 0 0 0 0 0 0 0 7 0 0 0
